CCCACCCCCCCCCCCC
CACACCAAAAAACACC
CACAACAACAAAAAAA
CAAAAAAAACAAACCC
CAAAAAAAAAAACAAC
CAAACAAACCAAACAC
CAACAAAAACAAAAAC
CAAAACAAAAAAAAAC
CACAAAAACAAACAAC
CAACAACAAAAACAAC
CAAAAAAAAAAAAACC
CCCCCCCCCCCCCCCC