CCCCCCCCCCCCCCCC
CAAAAAAAAAAACAAC
AACAAACAAAAAAAAC
CAAAAACAAAAAACAC
CAACAAAAAAAACAAC
CAAAAAAAAAAAAAAC
CAAAAAAACAAAAAAC
CAACCAAAAAAACAAC
CAACAAAAAAAAACCC
CAAAAAAACCCAAAAC
CCAAAAAACAAAAAAA
CCCCCCCCCCCCCCCC